width 8
height 6
data
2 3 0 0 0 0 8 9
9 0 0 0 0 0 0 10
9 0 0 0 0 0 0 9
9 9 9 0 0 0 0 9
9 9 9 0 0 0 9 9
9 9 9 9 1 1 9 9