MainLevel
{
	width : 71
	height : 15
	offsetX : 2
	offsetY : 1
	tileLayer : 
	{
		9 10 10 10 9 10 10 8 10 10 10 10 5 10 8 10 10 10 10 10 10 10 10 8 10 10 10 10 5 10 8 8 10 10 10 10 5 10 8 8 10 10 10 10 5 10 8 8 10 10 10 10 5 10 8 8 10 10 10 10 5 10 10 10 10 10 10 10 10 7 7 
		8 10 11 10 8 10 11 10 5 4 5 0 0 10 10 10 10 8 8 10 10 8 10 10 5 4 5 0 0 10 10 10 5 4 5 0 0 10 10 10 5 4 5 0 0 10 10 10 5 4 5 0 0 10 10 10 5 4 5 0 0 10 10 10 8 8 10 10 8 8 10 
		10 10 10 11 10 10 10 10 0 0 0 0 0 0 0 0 0 0 0 0 0 0 0 10 0 0 0 0 0 0 0 10 0 0 0 0 0 0 0 10 0 0 0 0 0 0 0 10 0 0 0 0 0 0 0 10 0 0 0 0 0 0 0 0 0 0 0 0 0 10 11 
		9 10 10 10 10 8 10 0 0 0 0 0 0 0 0 0 0 0 0 0 0 0 0 0 0 0 0 0 2 0 0 0 0 0 2 0 0 0 0 0 0 0 0 0 0 0 0 0 0 0 0 0 0 0 0 0 0 0 0 0 0 0 0 0 0 0 0 0 0 11 11 
		8 10 11 10 9 10 10 0 0 0 0 0 0 0 0 0 0 10 9 10 10 0 0 0 0 0 0 0 6 0 0 0 0 0 6 0 0 0 0 0 0 0 0 0 0 0 0 0 0 0 0 0 0 0 0 0 0 0 0 0 0 0 0 0 0 0 0 0 0 10 10 
		10 10 10 10 8 10 11 0 0 0 0 0 0 0 0 0 0 10 8 10 11 0 0 0 0 0 0 0 7 7 0 0 0 7 7 0 0 0 0 0 0 0 0 0 0 0 0 0 0 0 0 0 0 0 0 0 0 0 0 0 0 0 0 0 0 0 0 0 0 0 0 
		10 8 10 11 10 10 10 0 0 0 0 0 0 0 0 0 0 11 10 9 10 10 0 0 0 0 0 0 8 10 0 0 0 8 10 0 0 0 0 0 0 0 0 0 0 0 0 0 0 0 0 0 0 0 0 0 0 0 0 0 0 0 0 0 0 0 0 0 0 0 0 
		9 10 10 10 10 8 10 0 0 0 0 0 0 0 0 0 0 10 10 8 10 11 0 0 0 0 0 0 10 11 0 0 0 10 11 0 0 0 0 0 0 0 0 0 0 0 0 0 0 0 0 0 0 0 0 0 0 0 0 0 0 0 0 0 0 0 0 0 0 0 0 
		8 10 11 10 9 10 10 0 0 0 0 0 0 0 0 0 0 0 11 10 9 10 10 0 0 0 0 0 11 11 0 0 0 11 11 0 0 0 0 0 0 0 0 0 0 0 0 0 0 0 0 0 0 0 0 0 0 0 0 0 0 0 0 0 0 10 9 9 10 7 7 
		10 10 10 10 8 10 11 0 0 0 0 0 0 0 0 0 0 0 10 10 8 10 11 0 0 0 0 0 10 10 0 0 0 10 10 0 0 0 0 0 0 0 0 0 0 0 0 0 0 0 0 0 0 0 0 0 0 0 0 0 0 0 0 0 0 0 0 0 0 8 10 
		10 8 10 11 10 10 10 0 0 0 0 0 0 1 0 0 0 0 0 11 10 10 10 0 0 0 0 0 0 0 0 0 0 0 0 0 0 0 0 0 0 0 0 0 0 0 0 0 0 0 0 0 0 0 0 0 0 0 0 0 0 0 0 0 0 0 0 0 0 10 11 
		9 10 10 10 10 8 10 0 0 0 2 0 0 1 0 0 2 0 0 10 10 8 10 0 0 0 0 0 0 0 0 0 0 0 0 0 0 0 0 0 0 0 0 0 0 0 0 0 0 0 0 0 0 0 0 0 0 0 0 0 0 0 0 0 0 0 0 0 0 11 11 
		8 10 11 10 9 10 10 0 0 0 1 1 0 6 0 1 1 0 0 0 0 0 0 0 0 0 0 0 1 1 1 1 1 1 1 0 0 0 0 0 0 0 0 0 0 0 0 0 0 0 0 0 0 0 0 0 0 0 0 0 0 0 0 0 0 0 0 0 0 10 10 
		10 10 10 10 8 10 11 10 3 3 3 3 10 3 3 10 3 3 3 3 10 3 3 10 3 3 3 3 10 3 3 10 3 3 3 3 10 3 3 10 3 3 3 3 10 3 3 10 3 3 3 3 10 3 3 10 3 3 3 3 10 3 3 10 3 3 3 3 10 3 3 
		10 8 10 11 10 10 10 10 10 8 8 10 10 8 10 10 10 8 8 10 10 8 10 10 10 8 8 10 10 8 10 10 10 8 8 10 10 8 10 10 10 8 8 10 10 8 10 10 10 8 8 10 10 8 10 10 10 8 8 10 10 8 10 10 10 8 8 10 10 8 10 
	}
	numObjects : 0
	objectLayer : 
	{
	}
}
