MainLevel
{
	width : 33
	height : 15
	offsetX : 2
	offsetY : 1
	tileLayer : 
	{
		8 9 9 9 8 9 9 7 9 9 9 9 4 9 7 9 9 9 9 9 9 9 9 7 9 9 9 9 4 9 7 7 9 
		7 9 10 9 7 9 10 9 4 3 4 0 0 9 9 9 9 7 7 9 9 7 9 9 4 3 4 0 0 9 9 9 4 
		9 9 9 10 9 9 9 9 0 0 0 0 0 0 0 0 0 0 0 0 0 0 0 9 0 0 0 0 0 0 0 9 0 
		8 9 9 9 9 7 9 0 0 0 0 0 0 0 0 0 0 0 0 0 0 0 0 0 0 0 0 0 0 0 0 0 0 
		7 9 10 9 8 9 9 0 0 0 0 0 0 0 0 0 0 9 8 9 9 0 0 0 0 0 0 0 0 0 0 0 0 
		9 9 9 9 7 9 10 0 0 0 0 0 0 0 0 0 0 9 7 9 10 0 0 0 0 0 0 0 0 0 0 0 0 
		9 7 9 10 9 9 9 0 0 0 0 0 0 0 0 0 0 10 9 8 9 9 0 0 0 0 0 0 0 0 0 0 0 
		8 9 9 9 9 7 9 0 0 0 0 0 0 0 0 0 0 9 9 7 9 10 0 0 0 0 0 0 0 0 0 0 0 
		7 9 10 9 8 9 9 0 0 0 0 0 0 0 0 0 0 0 10 9 8 9 9 0 0 0 0 0 0 0 0 0 0 
		9 9 9 9 7 9 10 0 0 0 0 0 0 0 0 0 0 0 9 9 7 9 10 0 0 0 0 0 0 0 0 0 0 
		9 7 9 10 9 9 9 0 0 0 0 0 0 5 0 0 0 0 0 10 9 9 9 0 0 0 0 0 0 0 0 0 0 
		8 9 9 9 9 7 9 0 0 0 1 0 0 5 0 0 1 0 0 9 9 7 9 0 0 0 0 0 0 0 0 0 0 
		7 9 10 9 8 9 9 0 0 0 5 5 0 5 0 5 5 0 0 0 0 0 0 0 0 0 0 0 0 0 0 0 0 
		9 9 9 9 7 9 10 9 2 2 2 2 9 2 2 9 2 2 2 2 9 2 0 0 0 0 0 0 0 0 0 0 0 
		9 7 9 10 9 9 9 9 9 7 7 9 9 7 9 9 9 7 7 9 9 7 0 0 0 0 0 0 0 0 0 0 0 
	}
	numObjects : 0
	objectLayer : 
	{
	}
}
